Kuchen	BACKEN
Torte	BACKEN
Muffins	BACKEN
Brot	BACKEN
Weckerl	BACKEN
Kekse	BACKEN
Bananenschnitte	KUCH
Guglhupf	KUCH
Schokoladekuchen	KUCH
Sachertorte	TORTE
Topfentorte	TORTE
backen	BACKEN
kochen	KOCHEN
zubereiten	KOCHEN	BACKEN
Eierspeise	WARME_SPEISE
Spaghetti	WARME_SPEISE
Pizza		WARME_SPEISE
Parkett	BODEN
Laminat	BODEN
Holzboden	BODEN
Teppich	BODEN
Wand	WAND
Stiegenhaus	WAND
reinigen	PUTZEN
aufr√§umen	PUTZEN
wischen		PUTZEN
saugen		PUTZEN